20
16
0
0
20
20
####################
#..................#
#................#.#
#.....#.#..#.....#.#
#......#.#.#.....#.#
#.....#.#..#.......#
#....#.............#
#..................#
#..................#
#..................#
#.........#..#.....#
#.........#..#.....#
#.........#..#.....#
#.........#..#.....#
#.........#..#.....#
#..##...###..#.....#
#..................#
#..................#
#..................#
####################
