20
16
0
0
19
11
    #####          
    #...#          
    #+..#          
  ###..+##         
  #..+.+.#         
###.#.##.#   ######
#...#.##.#####..oo#
#.+..+..........oo#
#####.###.#.##..oo#
    #.....#########
    #######        
